00100000000000000000
01000000001000001000
00000000000000010000
00000101000000000000
00000010000100000000
00010100001000010000
00000100101000000000
00000010010001000000
00000000001000000000
00000000000100000000